S,M,M,M,M,M,M,M,M,M,M,M,V,V,M,M,M,M,M,M,M,M,M,M,M,M,V,V
B,B,B,B,B,B,B,B,B,M,B,M,V,V,M,M,M,M,M,M,M,M,M,M,M,M,V,V
V,V,V,V,V,V,V,V,B,M,B,M,V,V,V,V,V,V,V,V,V,B,M,B,M,V,V,V
B,B,B,B,B,B,B,B,B,M,B,M,V,V,B,B,B,B,B,B,B,B,B,B,M,M,V,V
B,B,M,M,M,M,M,M,M,M,B,M,V,V,B,B,B,B,B,B,B,B,B,B,M,M,V,V
V,B,M,V,V,V,V,V,V,V,B,M,V,V,B,B,B,B,B,B,B,B,B,B,M,M,V,V
B,B,M,M,M,V,B,V,V,V,B,M,V,V,B,B,B,B,B,B,B,B,B,B,M,M,V,V
V,B,V,B,B,M,V,V,V,V,B,M,V,V,B,B,B,B,B,B,B,B,B,B,M,M,V,V
N,M,M,M,M,M,M,M,M,M,M,M,V,V,B,B,B,B,B,B,B,B,B,B,M,M,V,V
M,M,M,M,M,M,M,M,M,M,M,M,V,V,M,M,M,M,M,M,M,M,M,M,M,M,V,V
B,B,B,B,B,B,B,B,B,M,B,M,V,V,M,M,M,M,M,M,M,M,M,M,M,M,V,V
V,V,V,V,V,V,V,V,B,M,B,M,V,V,M,M,M,M,M,M,M,M,M,M,M,M,V,V
B,B,B,B,B,B,B,B,B,M,B,M,V,V,M,M,M,M,M,M,M,M,M,M,M,M,V,V
B,B,M,M,M,M,M,M,M,M,B,M,V,V,M,M,M,M,M,M,M,M,M,M,M,M,V,V
V,B,M,V,V,V,V,V,V,V,B,M,V,V,M,M,M,M,M,M,M,M,M,M,M,M,V,V
B,B,M,M,M,V,B,V,V,V,B,M,V,V,M,M,M,M,M,M,M,M,M,M,M,M,V,V
V,B,V,B,B,M,V,V,V,V,B,M,V,V,M,M,M,M,M,M,M,M,M,M,M,M,V,V
N,M,M,M,M,M,M,M,M,M,M,M,V,V,M,M,M,M,M,M,M,M,M,M,M,M,V,V